222222222222222
271333333333112
212323232323212
233333333333332
232323232323232
233333333333332
232323232323232
233333333333332
232323232323232
233333333333332
232323232323232
233333333333332
212323232323212
211333333333172
222222222222222

