222222222222222211122212222222222222222222222
222222222222222211122212222222222222222222222
222222222222222211122212222222222222222222222
222222222222222222222222222222222222222222222
222222222222222222222222222222222222222222222
222222222222222222222222222222222222222222222
222222222222222222222222222222222222222222222
222222222222222271333333333112222222222222222
222222222222222212323232323212222222222222222
222222222222222233333333333332222222222222222
222222222222222232321232123232222222222222222
222222222222222233311131113332222222222222222
222222222222222232321232123232222222222222222
222222222222222233333333333332222222222222222
222222222222222232321232123232222222222222222
222222222222222233311131113332222222222222222
222222222222222232321232123232222222222222222
222222222222222233333333333332222222222222222
222222222222222212323232323212222222222222222
222222222222222211333333333112222222222222222
222222222222222222222222222222222222222222222
222222222222222211122212222222222222222222222
222222222222222222222221122222222222222222222
222222222222222222112222222222222222222222222
222222222222222211122212222222222222222222222