22222222222222222222222
27131311131311131311112
21232123212311113131112
23333133313333113131112
21232123212321113131112
23111311131131113131112
21232123212321113131112
21333133313331113131112
21232123212321113131112
23111311131113113131112
21232123212321113131112
23333133313333113131112
21232123212321113131112
27777777777777777777772
22222222222222222222222
