2222222222
2111111112
2111111112
2111111112
2111111112
2111711112
2111111112
2111111112
2111111112
2222222222
