22222222222222222222
27113333333333331182
21212121281212121212
23333333333333333332
21212121211212121212
23333333333333333332
21212821211212821212
23333333333333333332
21212121211212121282
21313131311313131312
21313131311313131312
28212121211212121212
23333333333333333332
21212821211212821212
23333333333333333332
21212121211212121212
23333333333333333332
21212121218212121212
28113333333333331172
22222222222222222222