22222222222222222222
27777777777777777772
21212121211212121212
23333333333333333332
21212121211212121212
23333333333333333332
21212121211212121212
23333333333333333332
21212121211212121212
21313131311313131312
21313131311313131312
21212121211212121212
23333333333333333332
21212121211212121212
23333333333333333332
21212121211212121212
23333333333333333332
21212121211212121212
27777777777777777772
22222222222222222222