22222222222222222222
27111111122111111112
21212121222212121212
21111111122111111112
21212121111112121212
21111111111111111112
21212122211222121212
21111121111112111112
21211121111112111212
22221111122111112222
22221111122111112222
21211121111112111212
21111121111112111112
21212122211222121212
21111111111111111112
21212121111112121212
21111111122111111112
21212121222212121212
21111111122111111172
22222222222222222222