22222222222222222222
27113131322313131182
23232123222232123232
21313131322313131312
23232123133132123232
28111311181111311182
23232122233222123232
21313121311312131312
23231123333332113232
22223131322313132222
22223831322313832222
23231123333332113232
21313121311312131312
23232122233222123232
28111311118111311182
23232123133132123232
21313131322313131312
23232123222232123232
28113131322313131172
22222222222222222222