22222222222222222222
27113131322313131112
23232123222232123232
21313131322313131312
23232123133132123232
21111311111111311112
23232122233222123232
21313121311312131312
23231123333332113232
22223131322313132222
22223131322313132222
23231123333332113232
21313121311312131312
23232122233222123232
21111311111111311112
23232123133132123232
21313131322313131312
23232123222232123232
21113131322313131172
22222222222222222222